SO ./wolftex/redbrick.png
EA ./wolftex/wood.png  	
NO ./wolftex/greystone.png
WE ./wolftex/wood.png		 
C 255,200,160	 	 
F 122,122,122	 
			  
11111111111111111
10000000000000001
10100000100000101
10000000000000001
10001000100010001
10000000000000001
10101010N01010101
10000000000111001
100010001001 1001
10000000000111001
10100000100001001
10000000000000001
11111111111111111