			   SO  		./wolftex/redbrick.png   			
			 EA ./wolft   ex/wood.png  			  
  	NO 				./wolfte  x/greystone.png   
			WE 	./wolftex/wood.png		    
C 255,200,160	 	 
F 122,122,122	 
			  
11111111111111111
10000000000000001
10100000100000101
10000000000000001
10001000100010001
10000000000000001
10101010N01010101
10000000000111001
100010001001 1001
10000000000111011 111
10100000100001001 101
10000000000000001 1111
11111111111111111
11111111111111111
10000000000000001
10100000101000101
10000000000000001
10001000100010001
10000000000000001
10101010001010101
10000000000111001
100010001001 1001
10000000000111011 111
10100000100001001 101
10000000000000001 1111
11111111111111111
11111111111111111
10000000000000001
10100000100000101
10000000000000001
10001000100010001
10000000000000001
10101010001010101
10000000000111001
100010001001 1001
100000000001110111111
101000001000010010111
1000000000000000111111
11111111111111111
11111111111111111
10000000000000001
10100000100000101
10000000000000001
10001000100010001
10000000000000001
10101010001010101
10000000000111001
100010001001 1001
10000000000111011 111
10100000100001001 101
10000000000000001 1111
11111111111111111