
NO  ./path_to _the_north_texture

SO jkjjkj jkjk            

WE ./path_to_the_west_texture

EA ./path_to_the_east_texture    

    F 2, 90 , 98
C    225,30,0

1111111111
1001110N01
10010000011
1110 11111
1 1111 111