SO ./wolftex/redbrick.png
EA ./wolft   ex/wood.png  	
NO ./wolfte  x/greystone.png
WE ./wolftex/wood.png		 
C 255,200,160	 	 
F 122,122,122	 
		

      1111111
      1N1  111
      111  101
           111